The kids arent alright - The offspring
Why dont you get a job - The offspring 
You re gonna go far kid - The offspring 
Original Prankster - The offspring 
Want you bad - The offspring 
Toss the feathers (Live) - the corrs 
On top of the world - Imagine dragons 
She looks so perfect - 5 seconds to summer
take a walk - Passion pit
Tu - umberto tozzi
Down under - Men at work
Baby did a bad bad thing - Chris isaak
Killing in the name of - Rage against the machine
Baila morena - Zucchero
Baba O Riley - The Who
Just like Tiger Woods - Steel panther
If you really really love me - Steel panther
Community property - Steel panther
Celebration song - Unwritten law
Dont you (forget about me) - simple minds
Hearts burst into fire - Bullet for my valentine 
Tears dont fall - Bullet for my valentine
The holy war - Thin lizzy
Aince U been gone - kelly clakson 
Tornado of souls (remaster) - megadeth
I ll take care of you (Live) - Joe bonamassa and Beth Hart
Down the road - c2c
Your love - The outfield
I love LA - Rand Newman
Boys of summer - Don Henley